
MAZE: "mylevel", ' '
FLAGS:premapped
INIT_MAP: solidfill,' '
GEOMETRY:center,center
MAP
---------------------- 
|..L.......L......L...|
|..L..LLL..L.LLL..L...|
|..L..L....L...L..L...|
|.....L........L......|
---------------------- 
ENDMAP
REGION:(0,0,23,6),lit,"ordinary"
GOLD: 1,(10, 2)
GOLD: 1,(16, 3)
GOLD: 1,(7, 4)
GOLD: 1,(8, 4)
GOLD: 1,(16, 1)
GOLD: 1,(12, 4)
GOLD: 1,(9, 4)
GOLD: 1,(14, 3)
GOLD: 1,(2, 3)
GOLD: 1,(16, 2)
STAIR:(20, 3),down
BRANCH:(0,0,2,2),(0,0,0,0)
