
MAZE: "mylevel", ' '
FLAGS:premapped
INIT_MAP: solidfill,' '
GEOMETRY:center,center
MAP
---------------------- 
|..L.......L......L...|
|..L..LLL..L.LLL..L...|
|..L..L....L...L..L...|
|.....L........L......|
---------------------- 
ENDMAP
REGION:(0,0,23,6),lit,"ordinary"
GOLD: 1,(9, 2)
GOLD: 1,(8, 1)
GOLD: 1,(2, 1)
GOLD: 1,(1, 3)
GOLD: 1,(20, 1)
GOLD: 1,(13, 3)
GOLD: 1,(1, 4)
GOLD: 1,(20, 2)
GOLD: 1,(9, 1)
GOLD: 1,(1, 2)
STAIR:(20, 3),down
BRANCH:(0,0,2,2),(0,0,0,0)
