
MAZE: "mylevel", ' '
FLAGS:premapped
INIT_MAP: solidfill,' '
GEOMETRY:center,center
MAP
---------------------- 
|..L.......L......L...|
|..L..LLL..L.LLL..L...|
|..L..L....L...L..L...|
|.....L........L......|
---------------------- 
ENDMAP
REGION:(0,0,23,6),lit,"ordinary"
GOLD: 1,(4, 2)
GOLD: 1,(1, 4)
GOLD: 1,(19, 1)
GOLD: 1,(12, 1)
GOLD: 1,(1, 1)
GOLD: 1,(7, 4)
GOLD: 1,(20, 4)
GOLD: 1,(17, 1)
GOLD: 1,(7, 1)
GOLD: 1,(16, 1)
STAIR:(20, 3),down
BRANCH:(0,0,2,2),(0,0,0,0)
