
MAZE: "mylevel", ' '
FLAGS:premapped
INIT_MAP: solidfill,' '
GEOMETRY:center,center
MAP
---------------------- 
|..L.......L......L...|
|..L..LLL..L.LLL..L...|
|..L..L....L...L..L...|
|.....L........L......|
---------------------- 
ENDMAP
REGION:(0,0,23,6),lit,"ordinary"
GOLD: 1,random
GOLD: 1,random
GOLD: 1,random
GOLD: 1,random
GOLD: 1,random
GOLD: 1,random
GOLD: 1,random
GOLD: 1,random
GOLD: 1,random
STAIR:(18, 3),down
BRANCH:(0,0,2,2),(0,0,0,0)
